/*
 * null = sand (no building)
 * 1 = wall (blocks shots)
 * 2 = spawn (make it more road)
 * 3 = left (road)
 * 4 = right (road)
 * 5 = up (road)
 * 6 = down (road)
 * 7 = base (baseTile)
 * 8 = turret/grass
 * 
 */

//map01
function loadmap() {
	return help.asciiArtToMap([
			"12111111111111111121",
			"16111111111111111161",
			"16888888818888888861",
			"16888888818888888861",
			"1688   88188    8861",
			"1688   88188    8861",
			"1688   88188    8861",
			"16888888818888888861",
			"16888888818888888861",
			"16111111111111111161",
			"16888888818888888861",
			"16888888818888888861",
			"1688   88188    8861",
			"1688   88188    8861",
			"1688   88188    8861",
			"1688   88188    8861",
			"16888888818888888861",
			"16888888818888888861",
			"14444444473333333331",
			"11111111111111111111"
		],
		[[null, ' '],[1, '1'],[2, '2'],[3, '3'],[4, '4'],[5, '5'],[6, '6'],[7, '7'],[8, '8']]
	);
}

//map02
function loadmap() {
	return help.asciiArtToMap([
			"12111111111111111121",
			"16888888888888633331",
			"16888888888888688881",
			"1688        88688881",
			"1688        886888 1",
			"16888       886888 1",
			"168888      886888 1",
			"146888      88368881",
			"1846888     88836881",
			"11146111111111113611",
			"188846888     888331",
			"1 8884688      88831",
			"1 8888688      88831",
			"1  8886888     88831",
			"1   886888    633331",
			"1   8864478886388881",
			"1   8888158863888881",
			"1   888815863888   1",
			"1    88815338888   1",
			"11111111111111111111"
		],
		[[null, ' '],[1, '1'],[2, '2'],[3, '3'],[4, '4'],[5, '5'],[6, '6'],[7, '7'],[8, '8']]
	);
}

//map03
function loadmap() {
	return help.asciiArtToMap([
			"12111112111121111121",
			"1688 886 11 688 8861",
			"1688 886 11 688 8861",
			"1688 886 11 688 8861",
			"1688 886 11 688 8861",
			"1688 886 11 688 8861",
			"1688 886 11 688 8861",
			"1688 886 11 688 8861",
			"1688 886 11 688 8861",
			"1688 886 11 688 8861",
			"1688 886 11 688 8861",
			"1688 886 11 688 8861",
			"1688 886 11 688 8861",
			"1688 886 11 688 8861",
			"1688 886 11 688 8861",
			"1688 886 11 688 8861",
			"1688 886 11 688 8861",
			"14444444447333333331",
			"18888888811888888881",
			"11111111111111111111"
		],
		[[null, ' '],[1, '1'],[2, '2'],[3, '3'],[4, '4'],[5, '5'],[6, '6'],[7, '7'],[8, '8']]
	);
}